20 20
R05R07M05M06M06M07R01R02R02R02R02R02R02R02R02R02R03M05M07R04
R15R17M15X00X00M17X00X00X00X00X00X00X00X00X00X00X00M25M27R14
R25R27M15X00X00M17X00X00X00X00X00X00X00X00X00X00X00X00X00R14
M05M07M25M26M26M27X00X00X00X00X00X00X00R05R07X00X00X00X00R14
M15M17R05R07X00X00X00X00X00X00X00X00X00R25R27X00X00X00X00R14
M15M17R25R27X00X00X00X00X00X00X00X00X00M01M03X00X00X00X00R24
M15M17X00X00X00X00X00X00X00X00X00X00Y05Y07X00X00X00X00M05M07
M15M17X00X00X00X00X00X00X00X00X00C04Y15Y17X00X00X00X00M15M17
M25M27X00X00X00X00X00X00X15X17X00C24Y25Y27X00X00Y01Y03M15M17
M04X00X00X00X00X00X00X00X25X05G00M05M07X00X00X00X00X00M15M17
M14X00X00X00X00X00X00X00X00X25X27M15M17X00X00X00X00X00M15M17
M14X01X02X02X03X00X00G04X00X00X00M15M17R01R03X00X00X00M15M17
M14B05B07B04X00X00X00G14X00X00X00M15M17R00X00X00X00X00M15M17
M14B15B17B24X00X00X00G24G00X00X00M15M17X00X00X00X00X00M15M17
M14B25B27X00X00X01X03B05B07C01C03M25M27X00X00X00R05R07M15M17
M14X01X03X00X00B01B03B25B27X02X02X02C04X03X00X00R15R17M15M17
M14X00X00X00X00X00B04X00X00X00X00X00C24X00X00X00R15R17M15M17
M24X00X00X00X00X00B14X00X00X00X00X00M05M06M06M07R15R17M15M17
R05R06R06R06R06R07B24X06X06X06X06X06M15X06X06M17R15R17M15M17
R25R26R26R26R26R27R01R02R02R02R02R03M25M26M26M27R25R27M25M27
CAMERA 0 0 400 300
PLAYER1 R 32 32
PLAYER2 M 48 32
FLAG
Y 208 272
0
FLAG
B 224 272
0
FLAG
B 176 16
1
TILE_FLIP_EVENT
12 3 1 2
X00
X00
REMARK End flag
FLAG
Y 288 224
1
TILE_FLIP_EVENT
8 12 2 2
M00M04
X00M24
REMARK End flag
