30 20
Y04R05R06R06R06R06R07Y05Y06Y07G01G02G02G02G02G03Y01Y02Y02Y02Y03B05B07B05B06B06B07B05B06B07
Y24R25R26R26R26R26R27Y25Y26Y27Y05Y06Y07X00X00M01M02M03C01C02C03B25B27B15X00X00B17B25B26B27
G05G07X00X00X00X00X00X00X00X00Y15X00Y17X00X00X01X02X03X00X00X00X00X00B25B26B26B27C05C07R04
G15G17X00X00X00X00X00X00X00X00Y15X00Y17X00X00X00X00X00X00X00X00X00X00X00X00X00X00C25C27R24
G15G17W01W03X01X03X00X00X00X00Y25Y26Y27X00X00X00X00W05W07X00X00X00X00X00X00X00X00X00B05B07
G15G17X01X03X00X00X00X00X00X00B05B06B07X00X00X00X00W25W27W00X00X00X00X00B05B07X00X00B15B17
G15G17X00X00X05X06X07X00X00X00B15X00B17X00X00X00X00X00X00X00X00X00X00B00B25B27X00X00B15B17
G25G27X06X07Y05Y06Y07X00X00X00B25B26B27G05G07X00X00X00X00X00X00X00X00X00X00X00X00X00B25B27
Y05Y06Y06Y07Y15X26Y17Y05Y06Y06Y06Y06Y07G15G17M01M02M02M02M03X00X00X00X00X00X00X00Y05Y07M04
Y25Y26Y26Y27Y25Y26Y27Y25Y26Y26Y26Y26Y27G25G27Y01Y02Y02Y03X00X00X00X00X00X00X00X00Y25Y27M14
B05B06B07M05M06M06M06M07B05B06B07B01B02B03B05B07X05X07X00X00X00X00X00X00X00X00G05G06G07M14
B15X00B17M25M26M26M26M27B15X00B17C05C07X00B25B27X25X27X00X00X00C01C03X00X00X00G15X00G17M14
B25B26B27X00X00X00X00X00B25B26B27C25C27X00X00X00X00X00X00X00X00R01R02R03X00X00G15X00G17M14
C00X00X00X00X00X00X00X00X00Y05Y06Y07X00X00X00X00X00X00X01X03X00X00X00X00X00X00G25G26G27M24
B05B07X00X00X00X00X00X00X00Y15X00Y17X00X00X00X00X00X00W05W07X00X00X00X00X00X00X00X00Y05Y07
B15B17X00X00X00X00X00X00X00Y25Y26Y27X00X00X00X00X00W00W25W27X00X00X00X00X00X00X00X00Y15Y17
B25B27W00X00X00X00X00X00X00B05B06B07X00X00X00X00X00X00X00X00X00X00X00X00X00X01X02X03Y25Y27
C05C06C07X00X00X00X00X00X00B15X00B17B05B07X01X03X00X00X00X00X00X00X00X01X02X03Y05Y06Y06Y07
C15X00C17B05B06B06B06B06B07B15X00B17B15B17W05W07C00C01C02C03Y05Y06Y06Y06Y06Y07Y15X00X00Y17
C25C26C27B25B26B26B26B26B27B25B26B27B25B27W25W27G01G02G02G03Y25Y26Y26Y26Y26Y27Y25Y26Y26Y27
CAMERA 0 0 400 300
PLAYER1 Y 80 208
PLAYER2 B 80 32
FLAG
Y 32 256
1
TILE_FLIP_EVENT
9 4 3 3
X00X00X00
X00X00X00
X00X00X00
FLAG
B 32 64
1
TILE_FLIP_EVENT
10 12 3 3
X00X00X00
X00X00X00
X00X00X00
FLAG
R 368 128
0
FLAG
C 352 144
0
FLAG
Y 240 32
0
FLAG
B 272 256
0
