25 19
X00X00M05M07M05M06M06M06M07X00X00X01X03R05R07X00X00X00X00R01R02R02R03X00X00
X00X00M25M27M25M26M26M26M27X00X00M05M07R15R17R05R06R07X00X00Y05Y06Y06Y07X00
M05M06M07R01R03X00X00X00R05R06R07M25M27R25R27R25R26R27X00X00Y15X00X00Y17X00
M15X00M17X00X00X00X00X00R25R26R27X00X00X00X00X00Y05Y06Y06Y07Y15X04X00Y17X00
M25M26M27X00M05M06M07M05M06M06M07R05R06R07X00X00Y25Y26Y26Y27Y15X24X00Y17X00
X00X00X00B04M15X00M17M25M26M26M27R25R26R27X00X00R01R02R03X00Y25Y26Y26Y27X00
X00M05M07B14M25M26M27X00X00X00X00X00X00X00X00X00X00X00X00X00X00G05G07X00X00
X00M25M27B14X07W04X00X04X00W04X00W01W02W03X00W01W02W03X00W04X00G25G27X00X00
X00X00X00B14X17W14X00X24X00W14X00X00W04X00X00W04X00W04X00W14X00Y01Y02Y02Y03
B05B07X00B24X17W14X00W04X00W14X00X00W14X00X00W14X00W14X00W14X00X00Y05Y06Y07
B25B27M05M07X17W24X00W24X00W14X00X00W24X00X00W14X00W24X00W24X00X00Y15X00Y17
X00C00M25M27X27W01W02W02W02W03X00W01W02W03X00W24X00W01W02W03X00X00Y15X00Y17
X00B05B06B07X00B01B03X00X00X00X00X00X00G05G07X00X00X00C04G05G06G07Y25Y26Y27
X00B15X00B17X00X00C05C07X00X00C05C06C07G25G27X00X00X00C24G25G26G27X00X00X00
B04B25B26B27X00X00C25C27X00X00C15X00C17X00C05C07G05G07X00X00Y01Y02Y03G05G07
B14X00C01C02C03X00X00X00X00X00C25C26C27X00C15C17G25G27X00X00X00X00X00G15G17
B14X00B05B06B06B07X00C05C07X00X00X00X00X00C25C27X00X00G05G06G07X00X00G25G27
B14X00B25B26B26B27B04C15C17B05B07C01C02C02C03X07X00X00G15X00G17X00X00X00X00
B24X00X00X00X00X00B24C25C27B25B27X00G01G02G02G03X00X00G25G26G27X00G01G02G03
CAMERA 0 0 400 300
PLAYER1 M 80 240
PLAYER2 G 304 48
