20 20
X00X00X00X00X00X00X00X00X00X00X00X00X00X00X00X00X00X00X00R04
X00X00X00X00X00X00X00X00X00X00X00X00X00X00X00X00X00X00X00R14
X00X00X00X00X00X00X00X00X00X00X00X00X00X00X00X00X00X00X00R14
X00X00X00X00X00X00X00X00X00X00X00X00X00R05R07X00X00X00X00R14
X00X00X00X00X00X00X00X00X00X00X00X00X00R25R27X00X00X00X00R14
X00X00X00X00X00X00X00X00X00X00X00X00X00M01M03X00X00X00X00R24
X00X00X00X00X00X00X00X00M00M04X00X00Y05Y07X00X00X00X00M05M07
X00X00X00X00X00X00X00X00X00M24X00C04Y15Y17X00X00X00X00M15M17
X00X00X00X00X00X00X00X00X15X17X00C24Y25Y27X00X00Y01Y03M15M17
M04X00X00X00X00X00X00X00X25X05G00M05M07X00X00X00X00X00M15M17
M14X00X00X00X00X00X00X00X00X25X27M15M17X00X00X00X00X00M15M17
M14B01B02B02B03X00X00X00X00X00X00M15M17R01R03X00X00X00M15M17
M14X25X26X27X00X00X00G04X00X00X00M15M17R00X00X00X00X00M15M17
M14X00X00X00X00X00X00G24G00X00X00M15M17X00X00X00X00X00M15M17
M14X00X00X00X00B05B07C01C02C02C03M25M27X00X00X00R05R07M15M17
M14B01B03X00X00B25B27X00X01X02X02X02X02X03X00X00R15R17M15M17
M14X00X00X00X00X00B04X00X00X00X00X00X00X00X00X00R15R17M15M17
M24X00X00X00X00X00B14X00X00X00X00X00M05M06M06M07R15R17M15M17
R05R06R06R06R06R07B24X06X06X06X06X06M15X06X06M17R15R17M15M17
R25R26R26R26R26R27R01R02R02R02R02R03M25M26M26M27R25R27M25M27
CAMERA 0 0 400 300
PLAYER1 R 32 32
PLAYER2 M 48 32
