20 19
Y05Y07G01G02G02G03G05G06G07Y05Y07R05R07R05R06R07Y05Y06Y06Y07
Y15Y17R05R07Y01Y03G25G26G27Y15Y17R25R27R25R26R27Y25Y26Y26Y27
Y25Y27R25R27R05R06R06R07Y00Y25Y27Y01Y02Y03G05G07G01G03Y05Y07
Y04X17X00X00R25R26R26R27X00X00X01X02X02X03G25G27X00X00Y25Y27
Y14X17X00X00X00X00X00X00X00X00X00X00X00X00X00X00X00X00X00Y04
Y14G05G07X00X00X00X00X00R01R02R03X00X00X00X00X00X00X00X05Y14
Y14G25G27X00X00X00X00X00X00X05X06X06X06X06X06X06X06G05G07Y14
Y14X17X00X00X00X00X00X00X00X25X26X26X26Y05Y07X01X02G25G27Y14
Y14X17Y00Y05Y07X00X00X00X00X00X00X00X01Y25Y27X01X02X02X03Y14
Y14X17X00Y25Y27X00X00X00X00X00X00X00X00X00X00X00X00X00X00Y14
Y24X17G05G07X00X00X00X00Y05Y07Y00X00X00X00X00X00X00X00X00Y14
Y05Y07G15G17X00X00X00X00Y25Y27X00X00X00X00X00X00X00R05R07Y14
Y15Y17G25G27X06X07X00X00X00X00X00X00X00X00X00X00X00R25R27Y24
Y25Y27R04G04X00X17X00X00X00X00X00X00Y05Y07X00X00X00R04G05G07
Y04X05R24G14X00X17X00X00X00X00X00X00Y25Y27X00X00X00R14G15G17
Y14X25X27G14X00X17X00G05G06G06G06G07Y04R01R02R02R03R24G25G27
Y24X00X00G24Y05Y06Y07G15X00X00X00G17Y14X00X00Y05Y06Y06Y06Y07
Y05Y06Y06Y07Y15X00Y17G25G26G26G26G27Y24X00X00Y15X00X00X00Y17
Y25Y26Y26Y27Y25Y26Y27R01R02R02R02R03Y01Y02Y03Y25Y26Y26Y26Y27
CAMERA 0 0 400 300
PLAYER1 R 64 48
PLAYER2 G 80 48
