10 10
R00R00R00R00R00R00R00R05R06R07
R00X00X00X00X00X00X00R15X00R17
R00X00X00X00X00X00X00R25R26R27
R00X00X00X00X00X00X00X00X00R00
R00X00X00X00X00X00X00X00X00R00
R00X00X00X00X00X00X00X00X00R00
R00X00X00X00X00X00X00X00X00R00
R00X00X00X00X00X00X00X00X00R00
R00X00X00X00X00X00X00X00X00R00
R00R00R00R00R00R00R00R00R00R00
CAMERA 0 0 400 300
REMARK This is a test create line
PLAYER1 R 16 16
PLAYER2 M 48 16